############
###...... #..
###.####.#.#
###.####.#.#
###.####...#
###.####.###
#......#...#
#.#...#.#..#
#.#.##.#.#.#
#@#....#...#
###########