############
###.........
#..........#
#..........#
###........#
#.#......###
#......#...#
#......#...#
#......#...#
#......#...#
#@.....#...#
############