#############
#...#...#...#
#.#.#.#.#.#.#
#.#.#.......#
#@#...###.#.*
#############
