#############
#-......#.-.#
#.#####.#.#.#
#.#.........#
#.#.###.#.#.#
#...#-#...#.#
###.#.#.#.#.#
#...#.#.#.#.#
#.#.#.#.#.#.*
#@#...#.-.###
#############