##################
#@.....#-#.......#
######.#.#.#####.#
#-#....#.#..#...-#
#.#.####.##.#.####
#.....##....#....#
#####.##.#######.#
#.....##..#...##.#
#.#######...#....*
#.#...##########.#
#.#.#.####...##..#
#...#.####.#.#..##
#####..-...#...###
##################