##################
#.......-#..-#..-#
#.##.###.#.#.#.#.#
#..#-....#.#.#.#.#
##.#.#####.#...#.#
#..#.#...#.#####.#
#.##.#.#@#.#.....#
#..#.#.###.#.#####
##.#.#.....#.#...*
#..#.#######.#.#.#
#.##.........#.#.#
#.############.#.#
#................#
##################