##################
#@#...#...#...#..#
#...#...#...#...##
###############.##
#.............#..#
#.#######.#......#
#.......#.#.######
#######.#.#.#....#
#....##.#...#.##.#
#.......#........#
####.########.####
####.#....#......*
####......#.#....#
##################
