#############
#.......#...#
#.#####.#.#.#
#.#.........#
#.#.###.#.#.#
#...#.#...#.#
###.#.#.#.#.#
#...#.#.#.#.#
#.#.#.#.#.#.*
#@#...#...###
#############