############
#........#.*
#.#.####.#.#
#.#.#....#.#
#...##.#.#.#
###.##.#.#.#
#......#...#
#.#.##.#.#.#
#.#.##.#.#.#
#@#....#...#
############
