#############
#...#-..#.-.#
#.#.#.#.#.#.#
#.#.#..-....#
#@#...###-#.*
#############
