#############
#-..#...#.-.#
#.#.#.#.#.#.#
#.#.#.#.#.#.#
#.#.#.#.#.#.#
#.#.#.#.#.#.#
#.#.#.#.#.#.#
#.#-#.#.#.#-#
#.#.#.#.#.#.#
#@#...#...#.*
#############
