#############
#...#...#...#
#.#.#.#.#.#.#
#.#.#.#.#.#.#
#.#.#.#.#.#.#
#.#.#.#.#.#.#
#.#.#.#.#.#.#
#.#.#.#.#.#.#
#.#.#.#.#.#.#
#@#...#...#.*
#############
