############
#-...-...#.*
#.#.####.#.#
#.#.#-...#.#
#...##.#.#.#
###.##.#.#.#
#......#...#
#.#.##.#.#.#
#.#.##.#.#.#
#@#....#.-.#
############
