##################
#@#...#...#...#..#
#...#...#...#...##
###############.##
#-............#..#
#.#######.#......#
#.......#.#.######
#######.#.#.#....#
#.-..##.#...#.##.#
#.......#...-....#
####.########.####
####.#....#......*
####.....-#.#....#
##################
