##################
#........#...#...#
#.##.###.#.#.#.#.#
#..#.....#.#.#.#.#
##.#.#####.#...#.#
#..#.#...#.#####.#
#.##.#.#@#.#.....#
#..#.#.###.#.#####
##.#.#.....#.#...*
#..#.#######.#.#.#
#.##.........#.#.#
#.############.#.#
#................#
##################