##################
#@.....#.#.......#
######.#.#.#####.#
#.#....#.#..#....#
#.#.####.##.#.####
#.....##....#....#
#####.##.#######.#
#.....##..#...##.#
#.#######...#....*
#.#...##########.#
#.#.#.####...##..#
#...#.####.#.#..##
#####......#...###
##################